********************
*..................*
*.@....@....@....@.*
*..................*
*......**..........*
*.....***..........*
*......***.........*
*.@..............@.*
*........##........*
*........##........*
*........##........*
*........##........*
*.@..............@.*
*.........*........*
*........***.......*
*.........***......*
*..................*
*.@....@....@....@.*
*..................*
********************