*****************
*...............*
*.@...@...@...@.*
*...............*
*...@...@...@...*
*...............*
*.@...@...@...@.*
*...............*
*..@..@...@..@..*
*...............*
*.@...@...@...@.*
*...............*
*...@...@...@...*
*...............*
*.@...@...@...@.*
*...............*
*****************