*****************************
*...........................*
*.@.......@.......@.......@.*
*...........................*
*...........................*
*...........................*
*.....@.......@.......@.....*
*...........................*
*...........................*
*...........................*
*.@.......@.......@.......@.*
*...........................*
*...........................*
*...........................*
*..@......@.......@......@..*
*...........................*
*...........................*
*...........................*
*.@.......@.......@.......@.*
*...........................*
*...........................*
*...........................*
*.....@.......@.......@.....*
*...........................*
*...........................*
*...........................*
*.@.......@.......@.......@.*
*...........................*
*****************************