.#........
..@..#..#.
..#.......
.....#....
..#.....#.
..........
....#.....
.......@.#
..#...#...
.....#....