..*****..@..
..******....
...******...
..***.****..
..**...***..
..**...***..
......****..
..*******...
.@.*****....
....*****...
....****....
...****.....
............
...***...@..
...****.....
..******....
.*********..
************
************