.....*.....
.@...*...@.
.....*.....
...........
...........
***.....***
...........
...........
.....*.....
.@...*...@.
.....*.....