.....#.....
.@...#...@.
.....#.....
...........
...........
###.....###
...........
...........
.....#.....
.@...#...@.
.....#.....