.#.........#........
..@..#..#...@..#..#.
..#.........#.......
.....#.........#....
..#.....#...#.....#.
....................
....#.........#.....
.......@.#.......@.#
..#...#.....#...#...
.....#.........#....
.#.........#........
..@..#..#...@..#..#.
..#.........#.......
.....#.........#....
..#.....#...#.....#.
....................
....#.........#.....
.......@.#.......@.#
..#...#.....#...#...
.....#.........#....